...#M....
......#..
.#.P..Y..
.......c.
.###.....
.s..V...k