.P........####
......####....
###...##...f..
...S..g..F.###
...###........
.S...h.....#.S
......#....#..
##...B###M.#..
...........#..
...M#####.k...
.c............